6,6,6,4,4,4,4,4,6,6,6
6,6,3,2,2,2,2,2,3,6,6
6,3,2,0,0,0,0,0,2,3,6
4,2,0,0,0,0,0,0,0,2,4
4,2,0,0,0,0,0,0,0,2,4
4,3,0,0,0,0,0,0,0,3,4
4,3,0,0,0,0,1,1,0,3,4
4,3,0,0,0,0,1,1,0,3,4
4,3,0,0,0,0,0,0,0,3,4
4,3,0,2,0,0,0,0,0,3,4
4,3,0,2,2,0,0,0,0,3,4
4,3,0,0,0,0,0,0,0,3,4
4,3,0,0,0,0,0,0,0,3,4
4,3,0,0,0,1,0,0,0,3,4
4,3,0,0,1,1,1,0,0,3,4
4,3,1,1,1,1,1,1,1,3,4
4,3,2,2,2,2,2,2,2,3,4
4,4,2,2,2,2,2,2,2,4,4
4,4,4,4,2,2,2,4,4,4,4
4,3,5,4,2,2,2,4,4,4,4
4,3,5,4,4,4,4,4,4,4,4
4,3,5,6,6,5,5,5,4,4,4
4,3,5,6,6,6,6,5,4,4,4
6,5,5,6,6,6,5,5,4,4,4
6,5,5,7,7,7,5,4,4,4,4
6,5,5,7,7,7,5,4,4,4,4
6,5,5,7,7,7,5,4,4,4,4
6,5,5,7,7,7,5,4,4,4,5
6,6,7,7,7,7,7,6,6,6,6
6,6,6,6,6,6,6,6,6,6,6