3,3,11,41,41,41,41,11,11,11,3,3
3,3,3,3,41,100,41,11,3,3,3,3
3,3,3,3,3,41,41,41,3,3,3,3
3,3,3,3,3,31,31,3,31,3,3,3
3,3,3,3,3,31,31,32,3,3,3,3
3,3,3,3,31,31,31,31,3,3,3,3
3,3,3,3,33,35,31,31,3,3,3,3
3,3,3,3,33,31,31,34,3,3,3,3
3,3,3,3,3,31,34,3,3,3,3,3
3,3,3,3,3,35,31,3,3,3,3,3
3,3,3,3,3,31,31,3,3,3,3,3
3,3,3,3,3,31,31,3,3,3,3,3
3,3,3,3,3,31,31,3,3,3,3,3
3,3,3,3,3,3,3,3,3,3,3,3
3,3,3,3,3,3,3,3,3,3,3,3
3,3,3,3,3,3,3,3,3,3,3,3