3,3,11,11,11,11,11,11,11,11,3,3
3,3,3,3,11,100,101,11,3,3,3,3
3,3,3,3,3,11,11,3,3,3,3,3
3,3,3,3,3,11,11,3,3,3,3,3
3,3,3,3,3,11,11,3,3,3,3,3
3,3,3,3,11,11,11,11,3,3,3,3
3,3,3,3,11,11,11,11,3,3,3,3
3,3,3,3,11,11,11,11,3,3,3,3
3,3,3,3,3,11,11,3,3,3,3,3
3,3,3,3,3,11,11,3,3,3,3,3
3,3,3,3,3,11,11,3,3,3,3,3
3,3,3,3,3,11,11,3,3,3,3,3
3,3,3,3,3,11,11,3,3,3,3,3
3,3,3,3,3,3,3,3,3,3,3,3
3,3,3,3,3,3,3,3,3,3,3,3
3,3,3,3,3,3,3,3,3,3,3,3