0,0,0,6,6,6,6,6,6,6,0,0,0,5,5,5,5,5
0,0,0,5,5,5,5,5,5,0,0,0,5,2,2,3,3,5
0,0,0,0,4,4,4,4,3,3,0,0,2,2,1,1,3,5
0,0,3,3,3,3,0,0,0,0,3,0,0,0,1,1,3,5
0,0,4,3,3,3,0,0,0,0,0,0,0,0,0,2,3,2
0,0,4,3,3,2,0,0,0,0,0,0,0,0,2,3,2,0
0,0,3,1,1,0,0,0,0,0,0,0,0,2,3,2,0,0
0,0,5,1,1,0,0,0,0,4,3,3,3,3,2,0,0,0
0,5,5,0,0,0,0,0,0,5,0,0,2,2,0,5,5,0
0,5,5,0,0,0,0,2,2,5,5,0,0,0,0,0,0,0
0,5,5,0,0,0,0,0,0,5,5,0,0,0,0,0,0,0
0,0,5,0,4,0,0,0,0,5,5,0,0,3,5,5,0,0
0,0,5,1,0,0,0,0,1,5,4,0,3,4,5,4,5,0
0,0,3,2,2,0,0,3,2,4,3,0,3,4,4,3,5,0
0,0,0,3,4,0,0,4,0,3,0,0,3,4,3,3,0,0
0,0,0,0,3,0,0,3,0,0,0,0,0,2,1,1,2,0
0,0,0,0,0,0,0,0,0,0,0,0,0,0,0,0,0,0
2,2,2,2,2,0,0,0,0,0,0,2,2,2,2,2,2,2