0,0,5,5,5,5,5,5,5,5,0,0
0,0,0,6,5,5,5,5,6,0,0,0
0,0,0,7,6,5,5,6,7,0,0,0
0,0,0,0,7,5,5,7,0,0,0,0
0,0,0,7,6,5,5,6,7,0,0,0
0,0,7,6,5,5,5,5,6,7,0,0
0,0,7,6,5,5,5,5,6,7,0,0
0,0,7,6,5,5,5,5,6,7,0,0
0,0,0,7,6,5,5,6,7,0,0,0
0,0,0,7,6,5,5,6,7,0,0,0
0,0,0,7,6,5,5,6,7,0,0,0
0,0,0,7,6,0,0,6,7,0,0,0
0,0,0,7,6,0,0,6,7,0,0,0
0,0,0,7,6,6,6,6,7,0,0,0
0,0,0,7,7,7,7,7,7,0,0,0
0,0,0,0,0,8,8,8,0,0,0,0